111111
1C0001
100001
100001
111111