1111111111111
10000000000C1
1000111111001
1P0011E0C0001
1111111111111